1111111111111111111111111111111111111111
1                                      1
1                                      1
1                                      1
1                                      1
1                                      1
1                                      1
1                                      1
1                                      1
1                                      1
1                555555555555          1
1                4          4          1
1                4          4          1
1               64          422222222221
1          3     4          411111111111
1    1                      411111111111
1    1                      411111111111
1222212222222222255555555555511111111111
1111111111111111111111111111111111111111
1111111111111111111111111111111111111111

